This=Ce
procedure=procedure
program=programme
Contains=Contient
Class=Classe
Public=Publique
is=est
for=pour
aim=but
translate=traduire
English=anglais
French=francais
line=ligne
by=par
read=lire
a=un
the=le
method=methode
file=fichier
documentation=documentation
techique=technique
takes=prend
it=il
data=donnees
save=sauvegarder
in=en
It=Il
store=sauvegarder
dictionary=dictionaire
using=en utilisant
to=pour
from=a partir
and=et